00000000000000000000000000
00000000000000000000000000
00000000000000000000000000
00000000000000000000000000
00000000000000000000000000
00000000000000000000000000
00000000000000000000000000
00022220000000000443333000
00022220444444444403333000
00022220444444444403333000
00022220444444444403333000
00022220444444444403333000
00022224400000000003333000
00000000000000000000000000
00000000000000000000000000
00000000000000000000000000
00000000000000000000000000
00000000000000000000000000
00000000000000000000000000

(450, 450)




# 0 = Nothing
# 1 = Wall
# 2 = Start
# 3 = End
# 4 = Floor